P01111111111
011111111111
111101111111
111111111111
111111111111
